state,university/college,campus,student_enrollment,total_law_enforcement__employees,total_officers,total_civilians
ALABAMA,Bishop State Community College,Bishop State Community College main,3111,9,7,2
ALABAMA,Jacksonville State University,Jacksonville State University main,8314,18,13,5
ALABAMA,Northwest-Shoals Community College,Northwest-Shoals Community College main,3700,6,4,2
ALABAMA,Troy University,Troy University main,17765,29,27,2
ALABAMA,Tuskegee University,Tuskegee University main,2996,24,10,14
ALABAMA,University of Alabama: ,University of Alabama:  Huntsville,7866,23,16,7
ALABAMA,University of Alabama: ,University of Alabama:  Tuscaloosa,37098,105,87,18
ALABAMA,University of Montevallo,University of Montevallo main,3031,21,10,11
ALABAMA,University of North Alabama,University of North Alabama main,7078,16,14,2
ALABAMA,University of South Alabama,University of South Alabama main,16211,36,30,6
ALABAMA,University of West Alabama,University of West Alabama main,4032,14,9,5
ALABAMA,Wallace Community College,Wallace Community College Selma,1591,6,3,3
ALASKA,University of Alaska: ,University of Alaska:  Anchorage,16762,17,11,6
ALASKA,University of Alaska: ,University of Alaska:  Fairbanks,8638,12,6,6
ARIZONA,Arizona State University,Arizona State University Main Campus,90906,154,86,68
ARIZONA,Arizona Western College,Arizona Western College main,7514,13,8,5
ARIZONA,Central Arizona College,Central Arizona College main,5849,9,8,1
ARIZONA,Northern Arizona University,Northern Arizona University main,29021,34,21,13
ARIZONA,Pima Community College,Pima Community College main,26880,49,29,20
ARIZONA,University of Arizona,University of Arizona main,42595,112,59,53
ARIZONA,Yavapai College,Yavapai College main,7385,10,7,3
ARKANSAS,Arkansas State University: ,Arkansas State University:  Beebe,3935,6,5,1
ARKANSAS,Arkansas State University: ,Arkansas State University:  Jonesboro,13410,23,19,4
ARKANSAS,Arkansas State University: ,Arkansas State University:  Newport,2651,1,1,0
ARKANSAS,Arkansas Tech University,Arkansas Tech University main,12054,17,16,1
ARKANSAS,Henderson State University,Henderson State University main,3527,9,8,1
ARKANSAS,Southern Arkansas University,Southern Arkansas University main,4095,10,8,2
ARKANSAS,Southern Arkansas University Tech,Southern Arkansas University Tech main,1650,3,3,0
ARKANSAS,University of Arkansas: ,University of Arkansas:  Fayetteville,26754,53,37,16
ARKANSAS,University of Arkansas: ,University of Arkansas:  Little Rock,11891,48,29,19
ARKANSAS,University of Arkansas: ,University of Arkansas:  Medical Sciences,3021,52,40,12
ARKANSAS,University of Arkansas: ,University of Arkansas:  Monticello,3643,9,8,1
ARKANSAS,University of Arkansas: ,University of Arkansas:  Pine Bluff,2658,16,12,4
ARKANSAS,University of Central Arkansas,University of Central Arkansas main,11754,37,27,10
CALIFORNIA,Allan Hancock College,Allan Hancock College main,10949,10,5,5
CALIFORNIA,California State Polytechnic University: ,California State Polytechnic University:  Pomona,23717,41,18,23
CALIFORNIA,California State Polytechnic University: ,California State Polytechnic University:  San Luis Obispo,20944,35,19,16
CALIFORNIA,California State University: ,California State University:  Bakersfield,9228,21,13,8
CALIFORNIA,California State University: ,California State University:  Channel Islands,6167,29,15,14
CALIFORNIA,California State University: ,California State University:  Chico,17220,27,16,11
CALIFORNIA,California State University: ,California State University:  Dominguez Hills,14635,25,19,6
CALIFORNIA,California State University: ,California State University:  East Bay,15528,24,13,11
CALIFORNIA,California State University: ,California State University:  Fresno,24136,37,23,14
CALIFORNIA,California State University: ,California State University:  Fullerton,38948,40,26,14
CALIFORNIA,California State University: ,California State University:  Long Beach,37446,42,26,16
CALIFORNIA,California State University: ,California State University:  Los Angeles,27680,28,17,11
CALIFORNIA,California State University: ,California State University:  Monterey Bay,7102,27,15,12
CALIFORNIA,California State University: ,California State University:  Northridge,41548,35,20,15
CALIFORNIA,California State University: ,California State University:  Sacramento,30284,36,22,14
CALIFORNIA,California State University: ,California State University:  San Bernardino,20024,26,14,12
CALIFORNIA,California State University: ,California State University:  San Jose,32773,70,26,44
CALIFORNIA,California State University: ,California State University:  San Marcos,12793,26,21,5
CALIFORNIA,California State University: ,California State University:  Stanislaus,9282,19,11,8
CALIFORNIA,College of the Sequoias,College of the Sequoias main,11266,6,5,1
CALIFORNIA,Contra Costa Community College,Contra Costa Community College main,34910,34,22,12
CALIFORNIA,Cuesta College,Cuesta College main,9600,12,7,5
CALIFORNIA,El Camino College,El Camino College main,24001,32,23,9
CALIFORNIA,Foothill-De Anza College,Foothill-De Anza College main,37960,13,10,3
CALIFORNIA,Humboldt State University,Humboldt State University main,8790,20,12,8
CALIFORNIA,Irvine Valley College,Irvine Valley College main,13183,14,9,5
CALIFORNIA,Marin Community College,Marin Community College main,5490,6,4,2
CALIFORNIA,Pasadena Community College,Pasadena Community College main,27050,11,6,5
CALIFORNIA,Riverside Community College,Riverside Community College main,37594,24,18,6
CALIFORNIA,San Bernardino Community College,San Bernardino Community College main,19121,18,8,10
CALIFORNIA,San Diego State University,San Diego State University main,34254,49,24,25
CALIFORNIA,San Francisco State University,San Francisco State University main,30256,47,24,23
CALIFORNIA,San Jose/Evergreen Community College ,San Jose/Evergreen Community College  main,17136,15,7,8
CALIFORNIA,Santa Rosa Junior College,Santa Rosa Junior College main,22411,26,13,13
CALIFORNIA,Sonoma State University,Sonoma State University main,9408,21,14,7
CALIFORNIA,State Center Community College District,State Center Community College District main,32533,17,11,6
CALIFORNIA,University of California: ,University of California:  Berkeley,38189,125,58,67
CALIFORNIA,University of California: ,University of California:  Davis,35186,73,46,27
CALIFORNIA,University of California: ,University of California:  Irvine,30836,59,41,18
CALIFORNIA,University of California: ,University of California:  Los Angeles,41908,99,58,41
CALIFORNIA,University of California: ,University of California:  Merced,6685,21,12,9
CALIFORNIA,University of California: ,University of California:  Riverside,21385,44,31,13
CALIFORNIA,University of California: ,University of California:  San Diego,32906,69,36,33
CALIFORNIA,University of California: ,University of California:  San Francisco,3107,139,53,86
CALIFORNIA,University of California: ,University of California:  Santa Barbara,23497,54,39,15
CALIFORNIA,University of California: ,University of California:  Santa Cruz,17868,29,17,12
CALIFORNIA,Ventura County Community College District,Ventura County Community College District main,34022,17,16,1
CALIFORNIA,West Valley-Mission College,West Valley-Mission College main,17375,13,9,4
COLORADO,Adams State University,Adams State University main,3404,6,5,1
COLORADO,Arapahoe Community College,Arapahoe Community College main,10004,12,8,4
COLORADO,Auraria Higher Education Center2,Auraria Higher Education Center2 main,0,45,27,18
COLORADO,Colorado School of Mines,Colorado School of Mines main,6054,11,10,1
COLORADO,Colorado State University,Colorado State University Fort Collins,30614,46,32,14
COLORADO,Fort Lewis College,Fort Lewis College main,3707,10,8,2
COLORADO,Pikes Peak Community College,Pikes Peak Community College main,13311,20,18,2
COLORADO,Red Rocks Community College,Red Rocks Community College main,7789,9,6,3
COLORADO,University of Colorado:,University of Colorado: Boulder,33056,74,38,36
COLORADO,University of Colorado:,University of Colorado: Colorado Springs,11988,30,16,14
COLORADO,University of Colorado:,University of Colorado: Denver,23671,62,25,37
COLORADO,University of Northern Colorado,University of Northern Colorado main,12216,24,16,8
CONNECTICUT,Central Connecticut State University,Central Connecticut State University main,12086,26,19,7
CONNECTICUT,Eastern Connecticut State University,Eastern Connecticut State University main,5261,24,14,10
CONNECTICUT,Southern Connecticut State University,Southern Connecticut State University main,10473,33,27,6
CONNECTICUT,University of Connecticut: ,University of Connecticut:  Health Center2,0,45,19,26
CONNECTICUT,University of Connecticut: ,"University of Connecticut:  Storrs, Avery Point and Hartford2",0,88,77,11
CONNECTICUT,Western Connecticut State University,Western Connecticut State University main,5826,18,12,6
CONNECTICUT,Yale University,Yale University main,12385,104,87,17
DELAWARE,Delaware State University,Delaware State University main,4288,39,15,24
DELAWARE,University of Delaware,University of Delaware main,22852,75,49,26
FLORIDA,Florida A&M University,Florida A&M University main,9928,36,30,6
FLORIDA,Florida Atlantic University,Florida Atlantic University main,30380,60,36,24
FLORIDA,Florida Gulf Coast University,Florida Gulf Coast University main,14833,26,18,8
FLORIDA,Florida International University,Florida International University main,49782,83,56,27
FLORIDA,Florida SouthWestern State College,Florida SouthWestern State College main,15709,22,11,11
FLORIDA,New College of Florida,New College of Florida main,861,17,11,6
FLORIDA,Pensacola State College,Pensacola State College main,9840,11,9,2
FLORIDA,Santa Fe College,Santa Fe College main,14767,22,16,6
FLORIDA,Tallahassee Community College,Tallahassee Community College main,12445,23,12,11
FLORIDA,University of Central Florida,University of Central Florida main,62953,130,72,58
FLORIDA,University of Florida,University of Florida main,50645,127,82,45
FLORIDA,University of North Florida,University of North Florida main,15675,39,29,10
FLORIDA,University of South Florida: ,University of South Florida:  St. Petersburg,4739,22,16,6
FLORIDA,University of South Florida: ,University of South Florida:  Tampa,42067,68,51,17
FLORIDA,University of West Florida,University of West Florida main,12763,27,19,8
GEORGIA,Abraham Baldwin Agricultural College,Abraham Baldwin Agricultural College main,3393,14,13,1
GEORGIA,Agnes Scott College,Agnes Scott College main,902,16,9,7
GEORGIA,Albany State University,Albany State University main,3492,42,26,16
GEORGIA,Andrew College,Andrew College main,311,2,2,0
GEORGIA,Armstrong State University,Armstrong State University main,7103,23,15,8
GEORGIA,Augusta Technical College,Augusta Technical College main,4490,3,3,0
GEORGIA,Augusta University,Augusta University main,8333,62,45,17
GEORGIA,Bainbridge State College,Bainbridge State College main,2401,8,5,3
GEORGIA,Berry College,Berry College main,2245,18,13,5
GEORGIA,Chattahoochee Technical College,Chattahoochee Technical College main,9817,13,10,3
GEORGIA,Dalton State College,Dalton State College main,5044,16,13,3
GEORGIA,Emory University,Emory University main,13788,70,52,18
GEORGIA,Georgia College and State University,Georgia College and State University main,6889,23,17,6
GEORGIA,Georgia Gwinnett College,Georgia Gwinnett College main,11468,26,22,4
GEORGIA,Georgia Institute of Technology,Georgia Institute of Technology main,25034,97,71,26
GEORGIA,Georgia Military College,Georgia Military College main,7876,5,3,2
GEORGIA,Georgia Southern University,Georgia Southern University main,20459,51,40,11
GEORGIA,Georgia Southwestern State University,Georgia Southwestern State University main,2755,13,13,0
GEORGIA,Georgia State University,Georgia State University main,32058,261,120,141
GEORGIA,Gordon State College,Gordon State College main,4084,13,12,1
GEORGIA,Gwinnett Technical College,Gwinnett Technical College main,6959,2,1,1
GEORGIA,Kennesaw State University,Kennesaw State University main,33252,106,57,49
GEORGIA,Mercer University,Mercer University main,8600,31,22,9
GEORGIA,Middle Georgia State University,Middle Georgia State University main,7676,31,29,2
GEORGIA,Morehouse College,Morehouse College main,2167,22,7,15
GEORGIA,Savannah State University,Savannah State University main,4800,58,29,29
GEORGIA,Southern Crescent Technical College,Southern Crescent Technical College main,4867,5,5,0
GEORGIA,South Georgia State College,South Georgia State College main,2648,11,8,3
GEORGIA,Spelman College,Spelman College main,2144,31,18,13
GEORGIA,University of Georgia,University of Georgia main,36130,105,83,22
GEORGIA,University of North Georgia,University of North Georgia main,17289,41,32,9
GEORGIA,University of West Georgia,University of West Georgia main,12834,38,27,11
GEORGIA,Valdosta State University,Valdosta State University main,11302,29,21,8
GEORGIA,Wesleyan College,Wesleyan College main,708,9,9,0
GEORGIA,West Georgia Technical College,West Georgia Technical College main,6431,7,7,0
ILLINOIS,Illinois Central College,Illinois Central College main,9704,20,7,13
ILLINOIS,John Wood Community College,John Wood Community College main,2016,5,4,1
ILLINOIS,Joliet Junior College,Joliet Junior College main,14944,22,13,9
ILLINOIS,Lincoln Land Community College,Lincoln Land Community College main,6447,15,13,2
ILLINOIS,Parkland College,Parkland College main,8147,18,15,3
ILLINOIS,Prairie State College,Prairie State College main,4699,12,12,0
ILLINOIS,Rend Lake College,Rend Lake College main,2303,3,3,0
ILLINOIS,Southern Illinois University:,Southern Illinois University: Carbondale,17292,56,37,19
ILLINOIS,Southern Illinois University:,Southern Illinois University: Edwardsville,14265,47,37,10
ILLINOIS,Southern Illinois University:,Southern Illinois University: School of Medicine2,0,7,7,0
ILLINOIS,Triton College,Triton College main,11684,13,8,5
ILLINOIS,University of Illinois,University of Illinois Springfield,5402,22,15,7
INDIANA,Indiana University: ,Indiana University:  Bloomington,48514,39,38,1
INDIANA,Indiana University: ,Indiana University:  Southeast,6173,12,10,2
INDIANA,Purdue University,Purdue University main,40472,51,35,16
IOWA,Iowa State University,Iowa State University main,35714,50,36,14
IOWA,University of Iowa,University of Iowa main,30844,64,36,28
IOWA,University of Northern Iowa,University of Northern Iowa main,11981,17,14,3
KANSAS,Butler Community College,Butler Community College main,8950,10,8,2
KANSAS,Emporia State University,Emporia State University main,6094,9,8,1
KANSAS,Fort Hays State University,Fort Hays State University main,14210,8,8,0
KANSAS,Garden City Community College,Garden City Community College main,2099,2,2,0
KANSAS,Kansas City Kansas Community College,Kansas City Kansas Community College main,5625,18,17,1
KANSAS,Kansas State University,Kansas State University main,24146,41,21,20
KANSAS,University of Kansas,University of Kansas Main Campus,27259,60,23,37
KANSAS,Washburn University,Washburn University main,6615,21,17,4
KANSAS,Wichita State University,Wichita State University main,14240,40,26,14
KENTUCKY,Murray State University,Murray State University main,10998,16,16,0
KENTUCKY,Northern Kentucky University,Northern Kentucky University main,14699,20,15,5
KENTUCKY,Transylvania University,Transylvania University main,1053,11,9,2
KENTUCKY,Western Kentucky University,Western Kentucky University main,20063,30,21,9
LOUISIANA,Louisiana State University: ,Louisiana State University:  Baton Rouge,31524,70,54,16
LOUISIANA,Louisiana State University: ,"Louisiana State University:  Health Sciences Center, New Orleans",2791,32,32,0
LOUISIANA,Louisiana State University: ,"Louisiana State University:  Health Sciences Center, Shreveport",891,44,29,15
LOUISIANA,Louisiana State University: ,Louisiana State University:  Shreveport,4428,8,7,1
LOUISIANA,McNeese State University,McNeese State University main,8153,15,9,6
LOUISIANA,Nicholls State University,Nicholls State University main,6158,13,9,4
LOUISIANA,Northwestern State University,Northwestern State University main,9179,22,22,0
LOUISIANA,Southeastern Louisiana University,Southeastern Louisiana University main,14581,28,24,4
LOUISIANA,Southern University and A&M College: ,Southern University and A&M College:  New Orleans,2792,15,15,0
LOUISIANA,Southern University and A&M College: ,Southern University and A&M College:  Shreveport,3174,10,9,1
LOUISIANA,Tulane University,Tulane University main,12485,109,79,30
LOUISIANA,University of Louisiana,University of Louisiana Monroe,8804,20,19,1
LOUISIANA,University of New Orleans,University of New Orleans main,8423,20,19,1
MAINE,University of Maine: ,University of Maine:  Farmington,2016,5,4,1
MAINE,University of Maine: ,University of Maine:  Orono,10922,26,17,9
MAINE,University of Southern Maine,University of Southern Maine main,7739,18,10,8
MARYLAND,Bowie State University,Bowie State University main,5430,27,14,13
MARYLAND,Coppin State University,Coppin State University main,3108,31,22,9
MARYLAND,Frostburg State University,Frostburg State University main,5756,22,18,4
MARYLAND,Hagerstown Community College,Hagerstown Community College main,4276,2,2,0
MARYLAND,Morgan State University,Morgan State University main,7725,59,37,22
MARYLAND,Salisbury University,Salisbury University main,8671,30,17,13
MARYLAND,St. Mary's College,St. Mary's College main,1735,16,3,13
MARYLAND,Towson University,Towson University main,22284,53,36,17
MARYLAND,University of Baltimore,University of Baltimore main,6229,30,19,11
MARYLAND,University of Maryland: ,University of Maryland:  Baltimore City,6329,140,53,87
MARYLAND,University of Maryland: ,University of Maryland:  Baltimore County,13839,34,25,9
MARYLAND,University of Maryland: ,University of Maryland:  College Park,38140,127,83,44
MARYLAND,University of Maryland: ,University of Maryland:  Eastern Shore,4465,18,14,4
MASSACHUSETTS,Amherst College,Amherst College main,1795,19,14,5
MASSACHUSETTS,Assumption College,Assumption College main,2675,25,18,7
MASSACHUSETTS,Babson College,Babson College main,3057,29,20,9
MASSACHUSETTS,Becker College,Becker College main,2153,18,12,6
MASSACHUSETTS,Bentley University,Bentley University main,5552,33,22,11
MASSACHUSETTS,Boston College,Boston College main,14354,69,48,21
MASSACHUSETTS,Boston University,Boston University main,32158,68,53,15
MASSACHUSETTS,Brandeis University,Brandeis University main,5752,25,22,3
MASSACHUSETTS,Bridgewater State University,Bridgewater State University main,11089,22,19,3
MASSACHUSETTS,Bristol Community College,Bristol Community College main,8761,9,8,1
MASSACHUSETTS,Bunker Hill Community College,Bunker Hill Community College main,13142,16,15,1
MASSACHUSETTS,Cape Cod Community College,Cape Cod Community College main,3627,3,3,0
MASSACHUSETTS,Clark University,Clark University main,3485,14,12,2
MASSACHUSETTS,College of the Holy Cross,College of the Holy Cross main,2729,26,19,7
MASSACHUSETTS,Dean College,Dean College main,1363,15,1,14
MASSACHUSETTS,Emerson College,Emerson College main,4479,23,20,3
MASSACHUSETTS,Endicott College,Endicott College main,4695,21,17,4
MASSACHUSETTS,Fisher College,Fisher College main,1959,8,7,1
MASSACHUSETTS,Fitchburg State University,Fitchburg State University main,6598,21,16,5
MASSACHUSETTS,Framingham State University,Framingham State University main,6398,19,15,4
MASSACHUSETTS,Gordon College,Gordon College main,2045,5,5,0
MASSACHUSETTS,Greenfield Community College,Greenfield Community College main,2050,5,4,1
MASSACHUSETTS,Harvard University,Harvard University main,29652,99,77,22
MASSACHUSETTS,Holyoke Community College,Holyoke Community College main,6285,28,27,1
MASSACHUSETTS,Massachusetts Bay Community College,Massachusetts Bay Community College main,4859,7,7,0
MASSACHUSETTS,Massachusetts College of Art,Massachusetts College of Art main,1990,31,11,20
MASSACHUSETTS,Massachusetts College of Liberal Arts,Massachusetts College of Liberal Arts main,1641,15,10,5
MASSACHUSETTS,Massachusetts Institute of Technology,Massachusetts Institute of Technology main,11331,61,58,3
MASSACHUSETTS,Massasoit Community College,Massasoit Community College main,7637,19,17,2
MASSACHUSETTS,Merrimack College,Merrimack College main,3620,18,14,4
MASSACHUSETTS,Mount Holyoke College,Mount Holyoke College main,2215,52,38,14
MASSACHUSETTS,Mount Wachusett Community College,Mount Wachusett Community College main,4074,11,10,1
MASSACHUSETTS,Northeastern University,Northeastern University main,19940,94,62,32
MASSACHUSETTS,North Shore Community College,North Shore Community College main,6961,22,20,2
MASSACHUSETTS,Quinsigamond Community College,Quinsigamond Community College main,8064,17,14,3
MASSACHUSETTS,Regis College,Regis College main,1954,9,7,2
MASSACHUSETTS,Salem State University,Salem State University main,9215,23,19,4
MASSACHUSETTS,Springfield College,Springfield College main,3241,21,15,6
MASSACHUSETTS,Springfield Technical Community College,Springfield Technical Community College main,6286,19,16,3
MASSACHUSETTS,Stonehill College,Stonehill College main,2400,22,16,6
MASSACHUSETTS,Tufts University,Tufts University Medford,11137,81,43,38
MASSACHUSETTS,University of Massachusetts: ,University of Massachusetts:  Amherst,29269,69,60,9
MASSACHUSETTS,University of Massachusetts: ,University of Massachusetts:  Dartmouth,8916,34,24,10
MASSACHUSETTS,University of Massachusetts: ,"University of Massachusetts:  Harbor Campus, Boston",17030,38,26,12
MASSACHUSETTS,University of Massachusetts: ,"University of Massachusetts:  Medical Center, Worcester",1079,32,27,5
MASSACHUSETTS,Wellesley College,Wellesley College main,2510,19,14,5
MASSACHUSETTS,Wentworth Institute of Technology,Wentworth Institute of Technology main,4576,20,13,7
MASSACHUSETTS,Western New England University,Western New England University main,3912,29,17,12
MASSACHUSETTS,Westfield State University,Westfield State University main,6496,25,19,6
MASSACHUSETTS,Wheaton College,Wheaton College main,1598,15,12,3
MASSACHUSETTS,Worcester Polytechnic Institute,Worcester Polytechnic Institute main,6573,24,18,6
MICHIGAN,Central Michigan University,Central Michigan University main,26825,37,23,14
MICHIGAN,Delta College,Delta College main,9291,8,5,3
MICHIGAN,Eastern Michigan University,Eastern Michigan University main,21824,43,34,9
MICHIGAN,Ferris State University,Ferris State University main,14715,17,13,4
MICHIGAN,Grand Rapids Community College,Grand Rapids Community College main,14926,17,13,4
MICHIGAN,Grand Valley State University,Grand Valley State University main,25325,22,18,4
MICHIGAN,Kalamazoo Valley Community College,Kalamazoo Valley Community College main,8836,9,6,3
MICHIGAN,Kellogg Community College,Kellogg Community College main,5081,2,2,0
MICHIGAN,Kirtland Community College,Kirtland Community College main,1628,1,1,0
MICHIGAN,Lansing Community College,Lansing Community College main,14851,16,12,4
MICHIGAN,Macomb Community College,Macomb Community College main,22182,33,27,6
MICHIGAN,Michigan State University,Michigan State University main,50538,113,85,28
MICHIGAN,Michigan Technological University,Michigan Technological University main,7218,15,12,3
MICHIGAN,Mott Community College,Mott Community College main,8617,15,12,3
MICHIGAN,Northern Michigan University,Northern Michigan University main,8303,24,21,3
MICHIGAN,Oakland Community College,Oakland Community College main,21061,26,25,1
MICHIGAN,Oakland University,Oakland University main,20261,28,21,7
MICHIGAN,Saginaw Valley State University,Saginaw Valley State University main,9633,9,8,1
MICHIGAN,Schoolcraft College,Schoolcraft College main,11687,11,9,2
MICHIGAN,University of Michigan: ,University of Michigan:  Ann Arbor,43651,76,59,17
MICHIGAN,University of Michigan: ,University of Michigan:  Dearborn,9066,25,10,15
MICHIGAN,University of Michigan: ,University of Michigan:  Flint,8470,32,19,13
MICHIGAN,Western Michigan University,Western Michigan University main,23529,40,32,8
MINNESOTA,University of Minnesota:,University of Minnesota: Duluth,10878,10,8,2
MINNESOTA,University of Minnesota:,University of Minnesota: Morris,1856,5,3,2
MINNESOTA,University of Minnesota:,University of Minnesota: Twin Cities,50678,63,51,12
MISSISSIPPI,Coahoma Community College,Coahoma Community College main,2148,8,7,1
MISSISSIPPI,Mississippi State University,Mississippi State University main,20873,47,37,10
MISSISSIPPI,University of Mississippi: ,University of Mississippi:  Medical Center2,0,90,58,32
MISSISSIPPI,University of Mississippi: ,University of Mississippi:  Oxford,23212,44,28,16
MISSOURI,Jefferson College,Jefferson College main,4705,7,7,0
MISSOURI,Metropolitan Community College,Metropolitan Community College main,17821,37,27,10
MISSOURI,Mineral Area College,Mineral Area College main,4388,4,4,0
MISSOURI,Missouri Southern State University,Missouri Southern State University main,5783,8,7,1
MISSOURI,Missouri University of Science and Technology,Missouri University of Science and Technology main,8886,22,12,10
MISSOURI,Missouri Western State University,Missouri Western State University main,5513,12,10,2
MISSOURI,Southeast Missouri State University,Southeast Missouri State University main,11987,23,17,6
MISSOURI,St. Charles Community College,St. Charles Community College main,6865,14,11,3
MISSOURI,St. Louis Community College: ,St. Louis Community College:  Florissant Valley2,0,11,9,2
MISSOURI,St. Louis Community College: ,St. Louis Community College:  Meramec,18902,14,11,3
MISSOURI,Truman State University,Truman State University main,6208,12,10,2
MISSOURI,University of Central Missouri,University of Central Missouri main,14395,24,18,6
MISSOURI,University of Missouri: ,University of Missouri:  Columbia,35424,62,40,22
MISSOURI,University of Missouri: ,University of Missouri:  Kansas City,16685,39,26,13
MISSOURI,University of Missouri: ,University of Missouri:  St. Louis,16738,27,21,6
MONTANA,Montana State University,Montana State University main,15236,31,18,13
NEBRASKA,Metropolitan Community College,Metropolitan Community College Douglas County,14812,22,17,5
NEBRASKA,University of Nebraska:,University of Nebraska: Kearney,6747,11,10,1
NEBRASKA,University of Nebraska:,University of Nebraska: Lincoln,25260,60,34,26
NEVADA,College of Southern Nevada,College of Southern Nevada main,33313,40,19,21
NEVADA,University of Nevada:,University of Nevada: Las Vegas,28600,57,39,18
NEVADA,University of Nevada:,University of Nevada: Reno,20898,38,30,8
NEW HAMPSHIRE,University of New Hampshire,University of New Hampshire main,15351,31,17,14
NEW JERSEY,Brookdale Community College,Brookdale Community College main,13835,13,12,1
NEW JERSEY,Essex County College,Essex County College main,10954,66,10,56
NEW JERSEY,Kean University,Kean University main,14112,43,21,22
NEW JERSEY,Middlesex County College,Middlesex County College main,11662,17,12,5
NEW JERSEY,Monmouth University,Monmouth University main,6394,41,19,22
NEW JERSEY,Montclair State University,Montclair State University main,20465,47,37,10
NEW JERSEY,New Jersey Institute of Technology,New Jersey Institute of Technology main,11325,65,33,32
NEW JERSEY,Princeton University,Princeton University main,8138,100,32,68
NEW JERSEY,Rowan University,Rowan University main,16155,85,32,53
NEW JERSEY,Rutgers University: ,Rutgers University:  Camden,6408,93,19,74
NEW JERSEY,Rutgers University: ,Rutgers University:  Newark,11720,200,61,139
NEW JERSEY,Rutgers University: ,Rutgers University:  New Brunswick,49428,122,68,54
NEW JERSEY,Stevens Institute of Technology,Stevens Institute of Technology main,6359,22,20,2
NEW JERSEY,Stockton University,Stockton University main,8674,26,18,8
NEW JERSEY,The College of New Jersey,The College of New Jersey main,7406,30,18,12
NEW JERSEY,William Paterson University,William Paterson University main,10862,43,29,14
NEW MEXICO,Eastern New Mexico University,Eastern New Mexico University main,5725,9,8,1
NEW MEXICO,New Mexico Military Institute,New Mexico Military Institute main,428,5,5,0
NEW MEXICO,University of New Mexico,University of New Mexico main,27285,57,40,17
NEW MEXICO,Western New Mexico University,Western New Mexico University main,3354,7,6,1
NEW YORK,Cornell University,Cornell University main,21904,70,45,25
NEW YORK,Ithaca College,Ithaca College main,6769,33,16,17
NEW YORK,State University of New York: ,State University of New York:  Albany,17178,58,39,19
NEW YORK,State University of New York: ,State University of New York:  Binghamton,16913,48,32,16
NEW YORK,State University of New York: ,State University of New York:  Buffalo,29796,69,56,13
NEW YORK,State University of New York: ,State University of New York:  Downstate Medical Center,1858,103,25,78
NEW YORK,State University of New York: ,State University of New York:  Stony Brook,25272,143,68,75
NEW YORK,State University of New York: ,State University of New York:  Upstate Medical Center,1480,106,18,88
NEW YORK,State University of New York Agricultural and Technical College:,State University of New York Agricultural and Technical College: Alfred,3699,15,10,5
NEW YORK,State University of New York Agricultural and Technical College:,State University of New York Agricultural and Technical College: Canton,3140,9,8,1
NEW YORK,State University of New York Agricultural and Technical College:,State University of New York Agricultural and Technical College: Cobleskill,2441,11,10,1
NEW YORK,State University of New York Agricultural and Technical College:,State University of New York Agricultural and Technical College: Farmingdale,8648,31,21,10
NEW YORK,State University of New York Agricultural and Technical College:,State University of New York Agricultural and Technical College: Morrisville,2940,14,12,2
NEW YORK,State University of New York College:,State University of New York College: Brockport,8161,18,16,2
NEW YORK,State University of New York College:,State University of New York College: Buffalo,10330,35,32,3
NEW YORK,State University of New York College:,State University of New York College: Cortland,6926,24,18,6
NEW YORK,State University of New York College:,State University of New York College: Environmental Science and Forestry,2222,9,8,1
NEW YORK,State University of New York College:,State University of New York College: Fredonia,4842,16,15,1
NEW YORK,State University of New York College:,State University of New York College: Geneseo,5699,22,15,7
NEW YORK,State University of New York College:,State University of New York College: New Paltz,7751,25,21,4
NEW YORK,State University of New York College:,State University of New York College: Old Westbury,4353,21,16,5
NEW YORK,State University of New York College:,State University of New York College: Oneonta,6119,26,17,9
NEW YORK,State University of New York College:,State University of New York College: Optometry,381,15,6,9
NEW YORK,State University of New York College:,State University of New York College: Oswego,7937,27,21,6
NEW YORK,State University of New York College:,State University of New York College: Plattsburgh,5718,19,15,4
NEW YORK,State University of New York College:,State University of New York College: Potsdam,3904,12,9,3
NEW YORK,State University of New York College:,State University of New York College: Technology,3457,13,11,2
NEW YORK,State University of New York College:,State University of New York College: Utica-Rome,2779,16,11,5
NORTH CAROLINA,Appalachian State University,Appalachian State University main,17932,42,25,17
NORTH CAROLINA,Beaufort County Community College,Beaufort County Community College main,1820,3,3,0
NORTH CAROLINA,Belmont Abbey College,Belmont Abbey College main,1495,4,4,0
NORTH CAROLINA,Davidson College,Davidson College main,1784,10,9,1
NORTH CAROLINA,Duke University,Duke University main,15984,153,61,92
NORTH CAROLINA,East Carolina University,East Carolina University main,28289,64,51,13
NORTH CAROLINA,Elizabeth City State University,Elizabeth City State University main,1585,21,11,10
NORTH CAROLINA,Elon University,Elon University main,6631,24,16,8
NORTH CAROLINA,Fayetteville State University,Fayetteville State University main,6104,56,19,37
NORTH CAROLINA,Methodist University,Methodist University main,2474,24,11,13
NORTH CAROLINA,North Carolina Agricultural and Technical State University,North Carolina Agricultural and Technical State University main,10852,42,16,26
NORTH CAROLINA,North Carolina Central University,North Carolina Central University main,8011,51,25,26
NORTH CAROLINA,North Carolina School of the Arts,North Carolina School of the Arts main,970,22,15,7
NORTH CAROLINA,North Carolina State University,North Carolina State University Raleigh,34015,66,52,14
NORTH CAROLINA,Queens University,Queens University main,2286,11,8,3
NORTH CAROLINA,Saint Augustine's University,Saint Augustine's University main,810,20,1,19
NORTH CAROLINA,University of North Carolina:,University of North Carolina: Asheville,3891,22,15,7
NORTH CAROLINA,University of North Carolina:,University of North Carolina: Chapel Hill,29084,107,53,54
NORTH CAROLINA,University of North Carolina:,University of North Carolina: Charlotte,27983,48,38,10
NORTH CAROLINA,University of North Carolina:,University of North Carolina: Greensboro,19393,53,34,19
NORTH CAROLINA,University of North Carolina:,University of North Carolina: Pembroke,6441,21,17,4
NORTH CAROLINA,University of North Carolina:,University of North Carolina: Wilmington,14918,44,30,14
NORTH CAROLINA,Wake Forest University,Wake Forest University main,7837,47,23,24
NORTH CAROLINA,Western Carolina University,Western Carolina University main,10340,19,19,0
NORTH CAROLINA,Winston-Salem State University,Winston-Salem State University main,5107,40,15,25
NORTH DAKOTA,Bismarck State College,Bismarck State College main,4078,3,2,1
NORTH DAKOTA,North Dakota State College of Science,North Dakota State College of Science main,3123,4,3,1
NORTH DAKOTA,North Dakota State University,North Dakota State University main,14516,26,17,9
NORTH DAKOTA,University of North Dakota,University of North Dakota main,14951,21,19,2
OHIO,Bowling Green State University,Bowling Green State University main,16908,30,22,8
OHIO,Columbus State Community College,Columbus State Community College main,25983,50,29,21
OHIO,Miami University,Miami University main,19076,34,25,9
OHIO,Notre Dame College,Notre Dame College main,2094,11,9,2
OHIO,Ohio State University,Ohio State University Columbus,58663,57,47,10
OHIO,Ohio University,Ohio University main,29157,36,29,7
OHIO,Otterbein University,Otterbein University main,2808,10,9,1
OHIO,Sinclair Community College,Sinclair Community College main,18136,22,18,4
OHIO,University of Cincinnati,University of Cincinnati main,36042,134,68,66
OHIO,University of Toledo,University of Toledo main,20377,41,33,8
OHIO,Wright State University,Wright State University main,17070,27,18,9
OKLAHOMA,Cameron University,Cameron University main,5177,13,13,0
OKLAHOMA,East Central University,East Central University main,4444,6,5,1
OKLAHOMA,Langston University,Langston University main,2543,16,12,4
OKLAHOMA,Northeastern Oklahoma A&M College,Northeastern Oklahoma A&M College main,2107,6,6,0
OKLAHOMA,Northeastern State University,Northeastern State University Tahlequah,8251,19,15,4
OKLAHOMA,Oklahoma City University,Oklahoma City University main,2991,12,8,4
OKLAHOMA,Oklahoma State University:,Oklahoma State University: Main Campus,25930,45,34,11
OKLAHOMA,Oklahoma State University:,Oklahoma State University: Okmulgee,2617,7,6,1
OKLAHOMA,Oklahoma State University:,Oklahoma State University: Tulsa,787,8,6,2
OKLAHOMA,Rogers State University,Rogers State University main,4081,9,9,0
OKLAHOMA,Seminole State College,Seminole State College main,1839,2,2,0
OKLAHOMA,Southeastern Oklahoma State University,Southeastern Oklahoma State University main,3754,6,5,1
OKLAHOMA,Southwestern Oklahoma State University,Southwestern Oklahoma State University main,5113,7,6,1
OKLAHOMA,Tulsa Community College,Tulsa Community College main,17160,34,27,7
OKLAHOMA,University of Central Oklahoma,University of Central Oklahoma main,16910,28,17,11
OKLAHOMA,University of Oklahoma: ,University of Oklahoma:  Health Sciences Center,3389,60,39,21
OKLAHOMA,University of Oklahoma: ,University of Oklahoma:  Norman,27428,67,40,27
OREGON,Portland State University,Portland State University main,27488,29,10,19
OREGON,University of Oregon,University of Oregon main,24032,42,23,19
PENNSYLVANIA,Bloomsburg University,Bloomsburg University main,9737,21,16,5
PENNSYLVANIA,California University,California University main,7854,21,17,4
PENNSYLVANIA,Cheyney University,Cheyney University main,711,16,9,7
PENNSYLVANIA,Clarion University,Clarion University main,5368,14,8,6
PENNSYLVANIA,Dickinson College,Dickinson College main,2420,20,14,6
PENNSYLVANIA,East Stroudsburg University,East Stroudsburg University main,6828,14,11,3
PENNSYLVANIA,Edinboro University,Edinboro University main,6548,15,14,1
PENNSYLVANIA,Indiana University,Indiana University main,13835,31,21,10
PENNSYLVANIA,Kutztown University,Kutztown University main,8995,19,16,3
PENNSYLVANIA,Lehigh University,Lehigh University main,7054,35,26,9
PENNSYLVANIA,Lock Haven University,Lock Haven University main,4607,12,9,3
PENNSYLVANIA,Mansfield University,Mansfield University main,2352,11,8,3
PENNSYLVANIA,Millersville University,Millersville University main,7959,16,14,2
PENNSYLVANIA,Moravian College,Moravian College main,2261,17,14,3
PENNSYLVANIA,Pennsylvania State University:,Pennsylvania State University: Altoona,3839,9,7,2
PENNSYLVANIA,Pennsylvania State University:,Pennsylvania State University: Beaver,705,6,6,0
PENNSYLVANIA,Pennsylvania State University:,Pennsylvania State University: Behrend,4327,11,7,4
PENNSYLVANIA,Pennsylvania State University:,Pennsylvania State University: Berks,2906,9,8,1
PENNSYLVANIA,Pennsylvania State University:,Pennsylvania State University: Brandywine,1457,3,3,0
PENNSYLVANIA,Pennsylvania State University:,Pennsylvania State University: Greater Allegheny,577,5,5,0
PENNSYLVANIA,Pennsylvania State University:,Pennsylvania State University: Harrisburg,4678,9,8,1
PENNSYLVANIA,Pennsylvania State University:,Pennsylvania State University: Hazleton,831,5,5,0
PENNSYLVANIA,Pennsylvania State University:,Pennsylvania State University: Mont Alto,893,5,5,0
PENNSYLVANIA,Pennsylvania State University:,Pennsylvania State University: Schuylkill,783,4,4,0
PENNSYLVANIA,Pennsylvania State University:,Pennsylvania State University: University Park,47307,74,44,30
PENNSYLVANIA,Pennsylvania State University:,Pennsylvania State University: Wilkes-Barre,501,1,1,0
PENNSYLVANIA,Pennsylvania State University:,Pennsylvania State University: Worthington Scranton,1034,2,2,0
PENNSYLVANIA,Shippensburg University,Shippensburg University main,7048,18,16,2
PENNSYLVANIA,Slippery Rock University,Slippery Rock University main,8611,19,12,7
PENNSYLVANIA,University of Pittsburgh: ,University of Pittsburgh:  Bradford,1453,8,6,2
PENNSYLVANIA,University of Pittsburgh: ,University of Pittsburgh:  Greensburg,1562,9,8,1
PENNSYLVANIA,University of Pittsburgh: ,University of Pittsburgh:  Johnstown,2816,13,12,1
PENNSYLVANIA,University of Pittsburgh: ,University of Pittsburgh:  Pittsburgh,28649,159,98,61
PENNSYLVANIA,University of Pittsburgh: ,University of Pittsburgh:  Titusville,346,7,6,1
PENNSYLVANIA,West Chester University,West Chester University main,16597,22,22,0
RHODE ISLAND,Brown University,Brown University main,9458,94,53,41
RHODE ISLAND,University of Rhode Island,University of Rhode Island main,16613,32,27,5
SOUTH CAROLINA,Bob Jones University,Bob Jones University main,3005,4,4,0
SOUTH CAROLINA,Clemson University,Clemson University main,22698,45,34,11
SOUTH CAROLINA,Coastal Carolina University,Coastal Carolina University main,10263,82,33,49
SOUTH CAROLINA,College of Charleston,College of Charleston main,11531,40,29,11
SOUTH CAROLINA,Columbia College,Columbia College main,1484,11,9,2
SOUTH CAROLINA,Denmark Technical College,Denmark Technical College main,1043,6,1,5
SOUTH CAROLINA,Erskine College,Erskine College main,761,3,2,1
SOUTH CAROLINA,Francis Marion University,Francis Marion University main,3947,14,9,5
SOUTH CAROLINA,Furman University,Furman University main,2884,20,14,6
SOUTH CAROLINA,Greenville Technical College,Greenville Technical College main,12280,17,9,8
SOUTH CAROLINA,Lander University,Lander University main,2701,20,13,7
SOUTH CAROLINA,Medical University of South Carolina,Medical University of South Carolina main,2992,77,56,21
SOUTH CAROLINA,Midlands Technical College,Midlands Technical College main,10946,10,10,0
SOUTH CAROLINA,Orangeburg-Calhoun Technical College,Orangeburg-Calhoun Technical College main,2774,5,5,0
SOUTH CAROLINA,Presbyterian College,Presbyterian College main,1379,8,7,1
SOUTH CAROLINA,South Carolina State University,South Carolina State University main,3054,22,12,10
SOUTH CAROLINA,Spartanburg Methodist College,Spartanburg Methodist College main,771,4,4,0
SOUTH CAROLINA,The Citadel,The Citadel main,3506,16,14,2
SOUTH CAROLINA,Tri-County Technical College,Tri-County Technical College main,6128,13,8,5
SOUTH CAROLINA,Trident Technical College,Trident Technical College main,15043,30,24,6
SOUTH CAROLINA,University of South Carolina:,University of South Carolina: Aiken,3448,7,6,1
SOUTH CAROLINA,University of South Carolina:,University of South Carolina: Beaufort,1980,11,11,0
SOUTH CAROLINA,University of South Carolina:,University of South Carolina: Columbia,33724,83,65,18
SOUTH CAROLINA,University of South Carolina:,University of South Carolina: Upstate,5996,15,14,1
SOUTH CAROLINA,Winthrop University,Winthrop University main,6031,20,14,6
SOUTH DAKOTA,South Dakota State University,South Dakota State University main,12576,17,12,5
TENNESSEE,Austin Peay State University,Austin Peay State University main,10099,26,17,9
TENNESSEE,Chattanooga State Community College,Chattanooga State Community College main,9374,15,8,7
TENNESSEE,Christian Brothers University,Christian Brothers University main,1842,18,6,12
TENNESSEE,Cleveland State Community College,Cleveland State Community College main,3509,4,3,1
TENNESSEE,East Tennessee State University,East Tennessee State University main,14334,26,19,7
TENNESSEE,Jackson State Community College,Jackson State Community College main,4746,5,4,1
TENNESSEE,Lincoln Memorial University,Lincoln Memorial University main,3983,24,8,16
TENNESSEE,Middle Tennessee State University,Middle Tennessee State University main,22511,42,33,9
TENNESSEE,Motlow State Community College,Motlow State Community College main,5256,2,2,0
TENNESSEE,Northeast State Community College,Northeast State Community College main,6084,8,8,0
TENNESSEE,Pellissippi State Community College,Pellissippi State Community College main,10325,12,4,8
TENNESSEE,Roane State Community College,Roane State Community College main,5861,7,7,0
TENNESSEE,Southwest Tennessee Community College,Southwest Tennessee Community College main,9135,20,17,3
TENNESSEE,Tennessee State University,Tennessee State University main,9167,44,30,14
TENNESSEE,Tennessee Technological University,Tennessee Technological University main,10900,21,13,8
TENNESSEE,University of Memphis,University of Memphis main,20585,70,41,29
TENNESSEE,University of Tennessee: ,University of Tennessee:  Chattanooga,11387,26,16,10
TENNESSEE,University of Tennessee: ,University of Tennessee:  Health Science Center,3075,53,22,31
TENNESSEE,University of Tennessee: ,University of Tennessee:  Knoxville,27845,93,53,40
TENNESSEE,University of Tennessee: ,University of Tennessee:  Martin,6827,15,11,4
TENNESSEE,University of the South,University of the South main,1797,14,10,4
TENNESSEE,Vanderbilt University,Vanderbilt University main,12567,268,97,171
TENNESSEE,Volunteer State Community College,Volunteer State Community College main,8098,12,9,3
TENNESSEE,Walters State Community College,Walters State Community College main,5947,9,7,2
TEXAS,Abilene Christian University,Abilene Christian University main,4544,15,14,1
TEXAS,Alamo Community College District,Alamo Community College District main,57165,91,75,16
TEXAS,Alvin Community College,Alvin Community College main,5114,13,11,2
TEXAS,Amarillo College,Amarillo College main,9936,12,11,1
TEXAS,Angelo State University,Angelo State University main,8483,16,11,5
TEXAS,Austin College,Austin College main,1255,7,6,1
TEXAS,Baylor Health Care System2,Baylor Health Care System2 main,0,169,58,111
TEXAS,Baylor University,Baylor University Waco,16787,56,36,20
TEXAS,Brookhaven College,Brookhaven College main,10553,26,16,10
TEXAS,Central Texas College,Central Texas College main,19562,8,7,1
TEXAS,College of the Mainland,College of the Mainland main,4013,7,7,0
TEXAS,El Paso Community College,El Paso Community College main,28764,43,36,7
TEXAS,Grayson College,Grayson College main,4591,6,5,1
TEXAS,Hardin-Simmons University,Hardin-Simmons University main,2112,8,7,1
TEXAS,Houston Baptist University,Houston Baptist University main,3160,16,13,3
TEXAS,Houston Community College,Houston Community College main,56522,111,72,39
TEXAS,Lamar University,Lamar University Beaumont,14965,59,26,33
TEXAS,Laredo Community College,Laredo Community College main,8749,24,22,2
TEXAS,McLennan Community College,McLennan Community College main,8305,14,9,5
TEXAS,Midwestern State University,Midwestern State University main,6043,14,9,5
TEXAS,Mountain View College,Mountain View College main,8539,12,12,0
TEXAS,North Lake College,North Lake College main,9871,25,24,1
TEXAS,Paris Junior College,Paris Junior College main,4999,4,4,0
TEXAS,Prairie View A&M University,Prairie View A&M University main,8315,24,19,5
TEXAS,Rice University,Rice University main,6719,48,31,17
TEXAS,Southern Methodist University,Southern Methodist University main,11643,37,29,8
TEXAS,South Plains College,South Plains College main,9126,6,6,0
TEXAS,Southwestern University,Southwestern University main,1515,7,6,1
TEXAS,Stephen F. Austin State University,Stephen F. Austin State University main,12606,49,26,23
TEXAS,St. Mary's University,St. Mary's University main,3625,21,17,4
TEXAS,Sul Ross State University,Sul Ross State University main,2967,10,8,2
TEXAS,Tarleton State University,Tarleton State University main,12330,19,15,4
TEXAS,Texas A&M International University,Texas A&M International University main,7192,29,19,10
TEXAS,Texas A&M University: ,Texas A&M University:  Central Texas,2466,11,7,4
TEXAS,Texas A&M University: ,Texas A&M University:  College Station,63813,132,65,67
TEXAS,Texas A&M University: ,Texas A&M University:  Commerce,12928,31,20,11
TEXAS,Texas A&M University: ,Texas A&M University:  Corpus Christi,11661,32,17,15
TEXAS,Texas A&M University: ,Texas A&M University:  Galveston2,0,10,9,1
TEXAS,Texas A&M University: ,Texas A&M University:  Kingsville,9207,21,16,5
TEXAS,Texas A&M University: ,Texas A&M University:  San Antonio,4564,18,12,6
TEXAS,Texas Christian University,Texas Christian University main,10323,56,32,24
TEXAS,Texas Southern University,Texas Southern University main,8965,76,31,45
TEXAS,Texas State Technical College: ,Texas State Technical College:  Harlingen2,0,13,10,3
TEXAS,Texas State Technical College: ,Texas State Technical College:  Waco2,0,12,11,1
TEXAS,Texas State Technical College: ,Texas State Technical College:  West Texas2,0,5,5,0
TEXAS,Texas State University,Texas State University San Marcos,37979,46,33,13
TEXAS,Texas Tech University,Texas Tech University Lubbock,35859,133,60,73
TEXAS,Texas Woman's University,Texas Woman's University main,15286,45,16,29
TEXAS,Trinity University,Trinity University main,2438,26,18,8
TEXAS,Tyler Junior College,Tyler Junior College main,10934,26,20,6
TEXAS,University of Houston: ,University of Houston:  Central Campus,42704,119,50,69
TEXAS,University of Houston: ,University of Houston:  Clearlake,8906,30,17,13
TEXAS,University of Houston: ,University of Houston:  Downtown Campus,14262,41,23,18
TEXAS,University of Mary Hardin-Baylor,University of Mary Hardin-Baylor main,3898,15,12,3
TEXAS,University of North Texas:,University of North Texas: Denton,37299,60,39,21
TEXAS,University of North Texas:,University of North Texas: Health Science Center,2382,21,12,9
TEXAS,University of Texas:,University of Texas: Arlington,41988,100,35,65
TEXAS,University of Texas:,University of Texas: Austin,50950,163,89,74
TEXAS,University of Texas:,University of Texas: Brownsville,4029,70,35,35
TEXAS,University of Texas:,University of Texas: Dallas,24554,70,27,43
TEXAS,University of Texas:,University of Texas: El Paso,23397,56,27,29
TEXAS,University of Texas:,"University of Texas: Health Science Center, Tyler2",0,29,8,21
TEXAS,University of Texas:,University of Texas: Houston,5115,356,96,260
TEXAS,University of Texas:,University of Texas: Permian Basin,6077,25,15,10
TEXAS,University of Texas:,University of Texas: San Antonio,28787,119,47,72
TEXAS,University of Texas:,University of Texas: Southwestern Medical School,2295,141,43,98
TEXAS,University of Texas:,University of Texas: Tyler,8785,29,12,17
TEXAS,West Texas A&M University,West Texas A&M University main,9489,21,15,6
UTAH,Brigham Young University,Brigham Young University main,33469,42,30,12
UTAH,Southern Utah University,Southern Utah University main,8881,6,5,1
UTAH,University of Utah,University of Utah main,31592,129,37,92
UTAH,Utah State University:,Utah State University: Eastern2,0,2,2,0
UTAH,Utah State University:,Utah State University: Logan,28622,18,12,6
UTAH,Utah Valley University,Utah Valley University main,33211,13,11,2
UTAH,Weber State University,Weber State University main,25955,13,11,2
VERMONT,University of Vermont,University of Vermont main,12815,33,21,12
VIRGINIA,Bridgewater College,Bridgewater College main,1834,13,7,6
VIRGINIA,Christopher Newport University,Christopher Newport University main,5172,27,18,9
VIRGINIA,College of William and Mary,College of William and Mary  ,8484,28,20,8
VIRGINIA,Eastern Virginia Medical School,Eastern Virginia Medical School main,1096,47,21,26
VIRGINIA,Emory and Henry College,Emory and Henry College main,1117,6,2,4
VIRGINIA,Ferrum College,Ferrum College main,1334,8,8,0
VIRGINIA,George Mason University,George Mason University main,33929,50,41,9
VIRGINIA,Germanna Community College,Germanna Community College main,6993,7,3,4
VIRGINIA,Hampton University,Hampton University main,4269,44,22,22
VIRGINIA,James Madison University,James Madison University main,21227,40,31,9
VIRGINIA,J. Sargeant Reynolds Community College,J. Sargeant Reynolds Community College main,10889,21,13,8
VIRGINIA,Longwood University,Longwood University main,5087,28,19,9
VIRGINIA,Lord Fairfax Community College,Lord Fairfax Community College main,7002,4,4,0
VIRGINIA,Norfolk State University,Norfolk State University main,5107,45,17,28
VIRGINIA,Northern Virginia Community College,Northern Virginia Community College main,52078,57,45,12
VIRGINIA,Old Dominion University,Old Dominion University main,24672,63,51,12
VIRGINIA,Radford University,Radford University main,9743,32,25,7
VIRGINIA,Richard Bland College,Richard Bland College main,2255,5,4,1
VIRGINIA,Thomas Nelson Community College,Thomas Nelson Community College main,9316,10,8,2
VIRGINIA,University of Mary Washington,University of Mary Washington main,4647,22,16,6
VIRGINIA,University of Richmond,University of Richmond main,4181,34,22,12
VIRGINIA,University of Virginia,University of Virginia main,23883,118,54,64
VIRGINIA,University of Virginia's College at Wise,University of Virginia's College at Wise main,2027,10,9,1
VIRGINIA,Virginia Commonwealth University,Virginia Commonwealth University main,30918,120,88,32
VIRGINIA,Virginia Military Institute,Virginia Military Institute main,1717,12,11,1
VIRGINIA,Virginia Polytechnic Institute and State University,Virginia Polytechnic Institute and State University main,32663,64,47,17
VIRGINIA,Virginia State University,Virginia State University main,4696,34,21,13
VIRGINIA,Virginia Western Community College,Virginia Western Community College main,7932,9,9,0
WASHINGTON,Central Washington University,Central Washington University main,11993,16,14,2
WASHINGTON,Eastern Washington University,Eastern Washington University main,12361,18,17,1
WASHINGTON,Evergreen State College,Evergreen State College main,4190,15,9,6
WASHINGTON,University of Washington,University of Washington main,45408,81,42,39
WASHINGTON,Washington State University: ,Washington State University:  Pullman,29686,23,18,5
WASHINGTON,Washington State University: ,Washington State University:  Vancouver2,0,6,3,3
WASHINGTON,Western Washington University,Western Washington University main,15332,20,15,5
WEST VIRGINIA,Bluefield State College,Bluefield State College main,1486,2,2,0
WEST VIRGINIA,Concord University,Concord University main,2507,9,6,3
WEST VIRGINIA,Fairmont State University,Fairmont State University main,4041,12,9,3
WEST VIRGINIA,Glenville State College,Glenville State College main,1732,5,3,2
WEST VIRGINIA,Marshall University,Marshall University main,13621,21,20,1
WEST VIRGINIA,Potomac State College,Potomac State College main,1475,7,6,1
WEST VIRGINIA,Shepherd University,Shepherd University main,3861,12,10,2
WEST VIRGINIA,West Liberty University,West Liberty University main,2341,5,5,0
WEST VIRGINIA,West Virginia State University,West Virginia State University main,3166,8,5,3
WEST VIRGINIA,West Virginia Tech,West Virginia Tech main,1263,7,7,0
WEST VIRGINIA,West Virginia University,West Virginia University main,28776,79,56,23
WISCONSIN,University of Wisconsin:,University of Wisconsin: Eau Claire,10592,11,11,0
WISCONSIN,University of Wisconsin:,University of Wisconsin: Green Bay,6784,11,10,1
WISCONSIN,University of Wisconsin:,University of Wisconsin: La Crosse,10490,15,12,3
WISCONSIN,University of Wisconsin:,University of Wisconsin: Madison,42716,117,60,57
WISCONSIN,University of Wisconsin:,University of Wisconsin: Milwaukee,26726,45,33,12
WISCONSIN,University of Wisconsin:,University of Wisconsin: Oshkosh,14051,14,11,3
WISCONSIN,University of Wisconsin:,University of Wisconsin: Parkside,4412,13,9,4
WISCONSIN,University of Wisconsin:,University of Wisconsin: Platteville,8945,10,8,2
WISCONSIN,University of Wisconsin:,University of Wisconsin: River Falls,5949,5,5,0
WISCONSIN,University of Wisconsin:,University of Wisconsin: Stevens Point,9265,5,3,2
WISCONSIN,University of Wisconsin:,University of Wisconsin: Stout,9554,11,9,2
WISCONSIN,University of Wisconsin:,University of Wisconsin: Superior,2497,7,2,5
WISCONSIN,University of Wisconsin:,University of Wisconsin: Whitewater,12360,16,14,2
WYOMING,University of Wyoming,University of Wyoming main,12648,24,14,10